F F F F F F F F F F F F F F F M M M M M M M M M M M M M M M M M M M M M M M M M M M
F G G F G F G F G G G G G G G M M M M M M M A A A A A M M M M M M A A A A M M M M M
F G G F G G G F G F G G G G G G M M M M M A A A A A A A M M M M A A A A A A M M M M   
F G F F G F G F G F G G F G G G G M A A A A A A A A A A A A A A A A A A A A A A M M
F G G G G F G F G F G G F G G G G M A M M A A A A A A A M M M M A A A A A A M M M M
F G F F G F G F G F G F F F G G G M A M M M A A A A A M M M M H M A A A A M H M M M 
F G F F G F G G G F G G G G G G G M A M M M M M M M M M M M M H M M M M M M H M M M
F G F F F F G F F F G G G G G G G M A M M M M M M M M M M M M H M M M M M M H M G M
F G G F G G G G G F G G H G G G G M A A A A A A A A A A A M M H M M M M M M H M G M
F F F F G F F F G G G H H H G G G M A M M M M M A M M M A M M H M M M M M M H M G M
F G G F G G G G G G H H H H H G G M M M F F F M M M F F F F F H G G M M G G H G G M
F G G F G G F G G G G H H H G G G G G G G G G G G G G G G G H H H H H H H H H G G M
F G G F G G F G G G G G H G G G G G G G G G G G G G G G G G H G G F G G G G G F G M
F G G F G G F G G G G G G G G G G F F F G G G F F F F G G G H G G G G G G F G F G M
F G G G G G G G G G G G G G G G G G G G G G G G G G G G G G H G F G F G F F G F G M
F G F F F F F G F F F G G G G G G G G G G G G G G G G G G G H G G G G G G G G G G M
F G G G G G G G G G G G G G G G G H H H H H H H H H H G G G G G M M M M M M M M M M
F G G G G G G G G H G G F G F G G H G G G G G G G G H G G G H G M A A A A A A A A M
F G F G G F G G G H G G G G G G G H G F G G G G F G H H H H H G M A M A A M A A A M
F G F G G F G G G H G G F G F G G G G G G G G G G G H G G G G G M A M M M M M M M M
F G F G G F G G G H G G G G G G G H G G G G G G G G H G G G M G M A A A A A A A A M
F G F G G F G G G H G F F F F G G H G F G G G G F G G G G G M G M A M M M M A M M M
F G G G G G G G G H G G G G G G G H G G G G G G G G H G M G M G M A A A A A A A A M
F G G G G G G G G G G F F F F G G H H H H G G H H H H G M G M G M M M A A M M M M M
F F F F F F F G G F F F F F F F F F G G G G G G G G H G M G M G G G G G G G G G G M 
F F F F F F G G F F F F F G F F F F G F F F G G G G H G M G G G G G G G G G G G G F
F G F G F G G G F F F F G G G F F F G F F F G G G G H G M G G G M M M M M M M M M M
M G G G F G G G F F F G G G G G F F G G G G G G G G H G G G G G G G G M G G G G G M
M G G G F G G G F F F F G G G F F F G F G G G G G G H G G G G G G G G M G G G G G M
M G G G G G G G G F F F F G F F F G G F G G G G G G H H H G H H H H G M G M M M M M
M G G G G G G G G G G G G G G G G G G G G G G G G G G G G G G G G H G G G G G G G M
M M M M M M M M M G G G G M M M M M M M G G M M M M G G G G G G G H M M M M M M G M
M A A A A A A A M G G G G M G G G G G G G G G G G M G G G G G G G H M M M M M M M M
M A M M A A A A M G G G G M G G G G G G G G F G G M G G H H H H H H H H M M H H H M
M A M M A A A A M G G G G M G F G G H H G G F G G M G G H H M H H H H H M M H H H M
M A A A A A A A M G G M G M G G G G H H G G F G G M G G H H H H M M H H M M H H H M
M A A A A A A A M G G M G G G G G G G G G G G G G M G G H H H H M M H H M M H H H M 
M A A A A A A M M M M M G G F G G G G G F F F G G M G G H H H H H H H H M M H H H M
M A A A A A A A A M M M G G F G H H H G G F G G G M G G H H H H H H H H M M H H H M
M A A A A A A A A M M M G G F G G G G G G F G G G M G G H H H H H H H H H H H H H M
M A A A A A A A A A G G G G G G G G G G G G G G G M M M H H H H H H H H H H H H H M
M M M M M M M M M M M M M M M M M M M M M M M M M M M M M M M M M M M M M M M M M M